00000000000000000000
00000000000000000000
00000000000000000000
0000000000000000000W
00W00000000000000WE0
pp0000000000000000pp
0000W0E00000000W0000
0W000pppppppppp000W0
p000000000000000000p
W0000000000000000000
0000W0E0000E000W000W
0W000pppppppppp000W0
p000000000000000000p
0000000000000000000W
00E00W00000000W00000
ppppp0000000000ppppp
00000000000000000000
0000000000000000000W
0000000000000000000W
DDDDDDDDDDDDDDDDDDDD