00000000000000000000
00000000000000000000
00000000000000000000
00000000000000000000
0E0000000000000000E0
pp0000000000000000pp
000000E0000000000000
00000pppppppppp00000
p000000000000000000p
00000000000000000000
000000E00E000E000000
00000pppppppppp00000
p000000000000000000p
00000000000000000000
00E0E000000000000E00
ppppp0000000000ppppp
00000000000000000000
00000000000000000000
00000000000000000000
DDDDDDDDDDDDDDDDDDDD