00000000000000000000
000000000000W0E000W0
W000W00000000ppppp00
0ppp0000000000000000
00W0000W0000W000W000
000pppp000000ppp0000
000000W000W00000W000
W000000ppp0000000ppp
00W00E0W0W00WW00W000
000pppp000pp00pp000W
ppp00000000000000000
p0000000000000000000
000000000000000W000p
00000000000WE000pppp
000E000W0000pppppppp
ppppppp0000000000000
000000000W00000E0000
W000000000pppppppppp
00000000000000E0000W
DDDDDDDDDDDDDDDDDDDD