00000000000000000000
00000000000000000000
0000000000000ppppp00
0ppp0000000000000000
00000000000000000000
000pppp000000ppp0000
00000000000000000000
0000000ppp0000000ppp
00000000000000000000
000pppp000pp00pp0000
ppp00000000000000000
p0000000000000000000
0000000000000000000p
0000000000000000pppp
000000000000pppppppp
ppppppp0000000000000
00000000000000000000
0000000000pppppppppp
00000000000000000000
DDDDDDDDDDDDDDDDDDDD