00000000000000000000
00000000000000000000
00000000000000000000
00000000000000000000
00000000000000000000
pppp0000000000000000
0000000ppppppp000000
00000000000000000000
00000000000000pppp00
00pppp00000000000000
00000000000000000000
00000000000000000000
000000pp000pppppp000
ppp00000000000000p00
000000000000000000p0
p000000000000000000p
000ppppp000000000000
000000000pppppppp000
00000000000000000000
DDDDDDDDDDDDDDDDDDDD