00000000000000000000
00000000000000000000
00000000000000000000
0000000000000000000W
0000W000000000000000
pppp00W00E0000W00000
0000000ppppppp000000
0000000000000WE000W0
0W0E00W0000000pppp00
00pppp00000000000000
00000000000000000000
00000W00W0W00E000W0W
000W00pp000pppppp000
ppp00000000000000p00
0W0000000000000000p0
p0W00000W0000000000p
000pppppW00000000W00
000000000pppppppp00W
0000000000000000E00W
DDDDDDDDDDDDDDDDDDDD