00000000000000000000
00000000000000000000
00000000000000000000
00000000000000000000
0000000000000000000W
000W000WE000W000WE00
ppp00000pppp00000ppp
0000W000W00WE00W0000
00000ppp0000ppp0000W
00W00000000000000W00
pp0E0W00000000W000Wp
00ppp0000000000ppp00
000000W00000W0000000
0000000ppppp00000W00
WW0E00W00000000000pp
00pppp000000W00000W0
0000000000000ppppp00
0000000000000000000W
00000000000000000000
DDDDDDDDDDDDDDDDDDDD