00000000000000000000
00000000000000000000
00000000000000000000
00000000000000000000
00000000000000000000
00000000E00000000E00
ppp00000pppp00000ppp
000000000000E0000000
00000ppp0000ppp00000
00000000000000000000
pp0000000000000000pp
00ppp0000000000ppp00
00000000000000000000
0000000ppppp00000000
000E00000000000000pp
00pppp00000000000000
0000000000000ppppp00
00000000000000000000
00000000000000000000
DDDDDDDDDDDDDDDDDDDD