00000000000000000000
00000000000000000000
00000000000000000000
00000000000000000000
00000000000000000000
pp0000000000000000pp
00000000000000000000
00000pppppppppp00000
p000000000000000000p
00000000000000000000
0000W0E00E000E0W0000
00000pppppppppp00000
p000000000000000000p
00000000000000000000
00000000000000000000
ppppp0000000000ppppp
00000000000000000000
00000000000000000000
00000000000000000000
DDDDDDDDDDDDDDDDDDDD